1111111111111111111111111111111111111111111111111111111111111111111111111111111111111111111111111111
1000000000000000000000001100000000011000000000000110000000000000000000000011000000000000000000000001
1000000000000000000000001100000000011000000000000110000000000000000000000011000000000000000000000001
1000000000000000000000001100000000011000000000000110000000000000000000000011000000000000000000000001
1000000000000000000000001100000000011111111000000110000000000000000000000011000000000000000000000001
1000000000000000000000001100000000000000000000000110000000000000000000000011000000000000000000000001
1000000000000000000000001100000000000000000000000110000000000000000000000011000000000000000000000001
1000000000000000000000000000000000000000000000000000000000000000000000000000000000000000000000000001
1000000000000000000000000000000000000000000000000000000000000000000000000000000000000000000000000001
1100000000000000000000000100000000000000000000000110000000000000000000000011000000000000000000000001
1000000000000000000000001100000000000000000000000110000000000000000000000011000000000000000000000001
1000000000000000000000001100000000000000000000000110000000000000000000000011000000000000000000000001
1000000000000000000000001100000000000000000000000110000000000000000000000011000000000000000000000001
1000000000000000000000001100000000000000000000000110000000000000000000000011000000000000000000000001
1111111100000111111111111111111110000011111111111111111111111111111111111111111111111111111111111111
1111111100000111111111111111111111111111111111111111111111111111111111111111111111111111111111111111
1000000000000000000000001100000000011000000000000110000000000110000000000011000000000000000000000001
1000000000000000000000001100000000011000000000000110000000000110000000000011000000000000000000000001
1000000000000000000000001100000000011000000000000110000000000110000000000011000000000000000000000001
1000000000000000000000001100000000011111111000000110000000000000000000000011000000000000000000000001
1000000000000000000000001100000000000000000000000110000000000000000000000011000000000000000000000001
1000000000000000000000001100000000000000000000000110000000222222000000000011000000000000000000000001
1000000000000000000000000000000000000000000000000000000000222222000000000000000000000000000000000001
1000000000000000000000000000000000000000000000000000000000222222000000000000000000000000000000000001
1100000000000000000000000100000000000000000000000110000000222222000000000011000000000000000000000001
1000000000000000000000001100000000000000000000000110000000000000000000000011000000000000000000000001
1000000000000000000000001100000000000000000000000110000000000000000000000011000000000000000000000001
1000000000000000000000001100000000000000000000000110000000000000000000000011000000000000000000000001
1000000000000000000000001100000000000000000000000110000000000000000000000011000000000000000000000001
1111111111111111111111111111111111111111111111111111111111111111111111111111111111111111111111111111