0001110100001001011000000010100010100000
0001000010000100001000000010100000000000
0000000000000000000000000000000000000000
0000000000000000000000000000000000000000
0000000000000000000000000000000000000000
0000000000000111111111111111111111111111
0000000000000000000001111111111111111111
0000000000111111111110000000000000000000
0000000000000000000000000000000000000000
0000000000000000000000000000000000000000